X                                     X
X                                     X
X                                     X
X                                     X
X             XXX                     X
XXXXXXXXX XX X       XXXX        XXXXXX 