X                                     X
X                                     X
X                                     X
X                                     X
X             XXX                     X
X   XX        XXX                     X
XXXXXXXXX XX X       XXXX        XXXXXX 