X                                     X
X                                     X
X                                     X
X                                     X
X                                     X
X                                     X
X                                     X
X                                     X
X   P         XXX                     X
X   XX        XXX                     X
XXXXXXXXX XX XX      XXXX        XXXXXX
XXXXXXXXXXXXXXXXXXXXXXXXXXX  XXXXXXXXXX
XXXXXXXXXXXXXXXXXXXXXXXXXXXXXXXXXXXXXXX
XXXXXXXXXXXXXXXXXXXXXXXXXXXXXXXXXXXXXXX
XXXXXXXXXXXXXXXXXXXXXXXXXXXXXXXXXXXXXXX 