X                                     X
X                                     X
X                                     X
X                                     X
X  P                                  X
X XX                                  X
X                                     X
X              R                      X
X             XXX                     X
X   XX        XXX                   G X
XXXXXXXXX XX XX      XXXX        XXXXXX
XXXXXXXXXXXXXXXXXXXXXXXXXXX  XXXXXXXXXX
XXXXXXXXXXXXXXXXXXXXXXXXXXXXXXXXXXXXXXX
XXXXXXXXXXXXXXXXXXXXXXXXXXXXXXXXXXXXXXX
XXXXXXXXXXXXXXXXXXXXXXXXXXXXXXXXXXXXXXX 